X X X X W W W W W W W W D W W W W W W W W X X X X
X X X X W N ~ * * * * * * * * * * * ~ N W X X X X
X X X X W ~ ~ * * * * * * * * * * * ~ ~ W X X X X
X X X X W * * * * * B * W * B * * * * * W X X X X
X X X X W * * * * * * * W S * * * * * * W X X X X
X X X X D * * * * * W W W W W * * * * * D X X X X
X X X X W * * * * * * * W * * * * * * * W X X X X
X X X X W * * * * * B * W * B * * * * * W X X X X
X X X X W ~ ~ * * * * * * * * * * * ~ ~ W X X X X
X X X X W N ~ * * * * * * * * * * * ~ N W X X X X
X X X X W W W W W W W W D W W W W W W W W X X X X
